%%%%%%%%%%%%%%%%%%%%%%%%%%%% 
%P                    %    %
%     .                    %
%                     %    %
%                     %%%%%%
%                          %
%           .%.  ....      %
%           %.  .          %
%           .%.            %
%%%%%%%%%%%%%%%%%%%      %%%
%                          %
%%%%   %     %             %
%  .   %     %     ...     %
%  .   %     %             %
%  .   %     %             %
%            %%%%%%%     %%%
%      .% %%%%     %.      %
%      .%          %.      %
%      .%         ...      %
%%%%%%%%%%%%%%%%%%%%%%%%%%%%
