%%%%%%%%%%%%%%%%%%%%%%%%%%%% 
%P                    %    %
%                     %    %
%                     %    %
%                     %%%%%%
%                          %
%           .%.            %
%           .%.            %
%           .%.            %
%%%.%%%%%%%%%%%%%%%      %%%
%                          %
%%%%   %     %             %
%  .   %     %             %
%  .   %     %             %
%  .   %     %             %
%  .......   %%%%%%%     %%%
%      % .%%%%     %.      %
%      % .         %.      %
%      % .        ...      %
%%%%%%%%%%%%%%%%%%%%%%%%%%%%