%%%%%%%%%%%%%%%%%%%%%%%%%%%%%%%%%%%%%%%%%%
%P                                       %
%       .                                %
%                                        %
%   %%%     %%%%%%%%%%%    %%%%%%%       %
%                          %             %
%               .%.  ....  %             %
%               %.  .      %             %
%               .%.         %%%%%%%%     %
%%%%%%%%%%%%%%%         %%%%             %
%          .%                        %   %
%   %%%    %%%%           %%%%%%    %%%  %
%     .    %     %                .%     %
%  .       %     %     ...         %     %
%          %     %                  %    %
%          %     %     %%%%         %    %
%                %%%%%%%     %%%%%%%%%   %
%      .% %%%%     %.     %%%%           %
%      .%          %.        %%%%%%      %
%      .%         ...                  %%%
%  %%%%%%               %%%%             %
%                          %             %
%               .%.  ....  %        .    %
%               %.  .      %             %
%               .%.         %%%%%%%%     %
%%%%%%%%%%%%%%%         %%%%             %
%          .%                        %   %
%   %%%    %%%%           %%%%%%    %%%  %
%     .    %     %                .%     %
%  .       %     %     ...         %     %
%          %     %                  %    %
%          %     %     %%%%         %    %
%                %%%%%%%     %%%%%%%%%   %
%      .% %%%%     %.     %%%%           %
%      .%          %.        %%%%%%      %
%      .%         .%                   %%%
%%%%%%%%%%%%%%%%%%%%%%%%%%%%%%%%%%%%%%%%%%

